{
  "name": "Level 1",
  "width": 10,
  "height": 10,
  "tiles": [
    "1 1 1 1 1 1 1 1 1 1",
    "1 P 0 0 1 0 0 0 0 1",
    "1 0 1 0 1 0 1 1 0 1",
    "1 0 1 0 0 0 0 K 0 1",
    "1 0 0 0 1 1 1 0 0 1",
    "1 0 1 0 0 0 0 0 E 1",
    "1 0 1 1 1 D 1 1 0 1",
    "1 0 0 0 0 0 0 0 0 1",
    "1 0 1 1 1 0 1 1 X 1",
    "1 1 1 1 1 1 1 1 1 1"
  ]
}